*****************************************************************
*                                                               *
*                                                               *
*                                                 <  8          *
*                                                               *
*                                                               *
*                                                               *
**********************                                          *
*                    *                                          *
*                    *                      2                   *
*                    *                                          *
*      5             *                                          *
*                    *                                          *
*                                                               *
*                                                               *
*****************************************************************


